ID	Name
StPwrKit	St.Power Kit
St.Pno 2	St. Piano 2
RokrSpin	Rocker Spin
StTrmStr	StTremString
St.Strs2	St.Strings 2
RmntcTrp	Romantic Trp
EnMuteTp	Enh.MutedTrp
StBigBrs	St.Big Brass
BlowTenr	Blown Tenor
BareBari	BareBaritone
Enh.Oboe	EnhancedOboe
JzClari2	Jazz Clari.2
ChoirPd2	Cosmic Voice
ClasOboe	Classic Oboe
BrtClari	Brt.Clarinet
StFrHorn	StFrenchHorn
St. Harp	Stereo Harp
Solo Trp	Solo Trumpet
St.Glock	St. Glocken