ID	Name
LayerCP1	Layered CP 1
GrndPnoK	GrandPiano K
MelloGrP	MellowGrdPno
PianoStr	PianoStrings
DreamPno	Dream Piano
DblConGr	DoublConGrnd
GrandP #	Grand Piano#
BritPnoK	BrightPianoK
BriteP #	BrightPiano#
EGndPnoK	ElGrndPianoK
Det.CP80	Detuned CP80
LayerCP2	Layered CP 2
HnkyTnkK	HonkyTonk K
EPiano1K	El.Piano 1 K
ChorusEP	Chorus EP 1
HardEPno	Hard El. Pno
VX E.Pno	VX El. Piano
60sElPno	60's ElPiano
EPiano1#	El. Piano 1#
EPiano2K	El.Piano 2 K
Chor.EP2	Chorus EP 2
VX EPno2	VX El.Piano2
EPiano2#	El. Piano 2#
HpschrdK	HarpsichordK
Hpschrd2	Harpsichord2
Hpschrd3	Harpsichord3
ClvchrdK	Clavichord K
ClaviWah	Wah Clvichrd
PulseClv	Pulse Clavi.
Perc Clv	Pierce Clavi
SupClavi	Super Clavi.
Clavi. #	Clavichord #
S. Orgel	Small Orgel
VibrafnK	Vibraphone K
HardVibr	HardVibrafon
SMarimba	Sine Marimba
ChrchBel	Church Bells
DetDrwOr	Det.DrawOrgn
60sDrOrg	60sDrawOrgan
60sDrOr2	60sDrawOrgn2
70sDrOrg	70sDrawOrgan
DrawOrg2	Draw Organ 2
60sDrOr3	60sDrawOrgn3
70sDrOr2	70sDrawOrgn2
CheezOrg	Cheese Organ
DrawOrg3	Draw Organ 3
ClkGspOr	ClikGospelOr
DrawOrg#	Draw Organ #
70sPcOrg	70s Perc Org
DetPrcOr	Det.Perc Org
LightOrg	Light Organ
PercOrg2	Perc Organ 2
PercOrg#	Perc Organ #
RotaryOr	Rotary Organ
SlwRotar	Slow Rotary
FstRotar	Fast Rotary
RockOrg#	Rock Organ #
ChurOrg3	ChurchOrgan3
ChurOrg2	ChurchOrgan2
OrgFlute	Organ Flute
TrmOrgFl	TremOrgFlute
AccordIt	Accordion It
Harmo. 2	Harmonica 2
TngoAcd2	TangoAccord2
NylonGt2	Nylon Gtr. 2
NylonGt3	Nylon Gtr. 3
VelGtHrm	VelGtHrmonix
NylonGt#	Nylon Gtr. #
SteelGt2	Steel Gtr. 2
12StrGtr	12-Str Gtr.
Nyln&Stl	Nyln&SteelGt
Stl&Body	SteelGt&Body
SteelGt#	Steel Gtr. #
MelloGtr	Mellow Gtr.
Jazz Amp	Jazz Gtr Amp
OctPlate	Octave Plate
NekRough	NeckRoughcst
PdlSteel	Pedal Steel
JazzGtr#	Jazz Gtr. #
ChorusGt	Chorus Gtr.
MidT.Gtr	MidToneGtr.
MidTGtSt	MidToneGtrSt
NasalGtr	Nasal Guitar
Funk Gtr	Funk Gtr. 1
MuteStlG	MutedSteelGt
FunkGtr2	Funk Guitar2
Mu.DstGt	MutedDistGtr
MutedGt#	Muted Gtr. #
OvdrGtDt	OvrdrvGtrDet
Gt.Pinch	Guitar Pinch
Ovrdriv#	Overdriven #
DstRthmG	DistRhythmGt
DistGtr2	Dist. Gtr. 2
DistGtr3	Dist. Gtr. 3
PowerGt2	Power Gtr. 2
PowerGtr	Power Gtr.
Dst.5ths	Dist. Fifths
FeedbkGt	Feedback Gt.
FeedbkG2	Feedback Gt2
RckRthm2	RockRhythm 2
RockRthm	Rock Rhythm
Dist.Gt#	Dist. Gtt. #
GtFeedbk	Gtr.Feedback
GtrHrmo2	Gtr. Harmo 2
JazzRthm	Jazz Rhythm
VXUprght	VX UprightBa
Acou.Ba#	Acou. Bass #
FingrDrk	DarkFingerBs
RezChase	Reso. Chase
FW EBass	FingrW EBass
FingrBa#	FingerBass #
PickBas2	Picked Bass2
M.PkBass	MutedPikBass
HardPick	HardPickBass
Fretles2	FretlessBas2
Fretles3	FretlessBas3
Fretles4	FretlessBas4
Pwr.Fret	PowerFretles
TalkinBa	Talking Bass
SynFretl	SynthFretles
SmthFrtl	SmoothFrtles
Fretles#	FretlesBass#
ResoSlap	ResonantSlap
PunchThm	PunchThumbBs
Thum&Slp	Thumb & Slap
SlapBas#	Slap Bass #
VeloSlap	VeloSwchSlap
SlapBa2#	Slap Bass 2#
SynBs1Dk	DarkSynBass1
FastResB	FastReso.Bas
ResoBass	ResonantBass
TechnoBa	Techno Bass
Sqr.Bass	Square Bass
RubberBa	Rubber Bass
HardReso	HardResonant
AnalogBa	Analog Bass
MelloSBa	MelloSynBass
Seq.Bass	SequencedBas
ClkSynBa	ClickSynthBs
SynBs2Dk	DarkSynBass2
SmthSynB	SmoothSynBas
ModulrBa	Modular Bass
X WireBa	X Wire Bass
AtkPulse	Attack Pulse
SmoothBa	Smooth Bass
Oct.Bass	Octave Bass
SlwVioln	Slow Violin
CadenzDk	Dark Cadenza
ViolinSc	Violin Sect.
HdVlnSec	HardViolnSec
SlVlnSec	SlowViolnSec
DoublViola	Double Viola
ViolaSec	Viola Sect.
HdVlaSec	HardViolaSec
SlVlaSec	SlowViolaSec
CellSect	Cello Sect.
HdCelloS	HardCelloSec
SlCelloS	SlowCelloSec
ContrSec	Contr. Sect.
HdContrS	HardContrSec
SlContrS	SlowContrSec
SlwTrStr	SlowTremStr.
Susp.Str	Suspense Str
Det.Fear	Detuned Fear
BrTrmStr	BriteTremStr
TremStr#	Tremolo Str#
PizzOcta	Pizz. Octave
ElecHarp	ElectricHarp
VlinHarp	Violin Harp
DtVliHrp	DetViolinHrp
SwellStr	SwellStrings
StSlwStr	St.Slow Str.
BriteTrp	BriteTrumpet
Dark Trp	Dark Trumpet
Soft Trp	Soft Trumpet
SweetTrp	SweetTrumpet
NormlTrp	Normal Trmpt
Bril Trp	BrilliantTrp
BrtTromb	Brt Trombone
MelloTrb	Mellow Tromb
BrilTrmb	BrillintTrmb
BrtBsTrb	BrtBassTromb
FrHrSolo	Fr.Horn Solo
BrtFrHrn	BrightFrHorn
StBrsSec	St.BrassSect
Tenor&Tp	Tenor&Trmpt
SymphBrs	Symph. Brass
LgtAltSx	Lgt.Alto Sax
FakeAlto	Fake Alto Sx
TenrSax2	Tenor Sax 2
SuperTnr	Super Tenor
BasClari	BassClarinet
NeatBrth	Neat Breathy
HollowSq	Hollow Sqr.
PolyPd80	Poly Pad 80
CutNoiz2	Cut Noise 2
DstCutNz	DistCutNoise
Str Slap	String Slap
P.Scrape	Pick Scrape
Fl.KClik	FluteKyClick
HorseGlp	Horse Gallop
DoorSqek	Door Squeak
ScratchC	Scratch Cut
Scratch2	ScratchSplit
TeleFon2	Telephone 2
CarTyreS	Car Tyre Sq.
Car Pass	Car Passing
LaughVox	Laugh Voice
ScreamVx	Scream Voice
MchinGun	Machine Gun
TechnoHi	Techno Kit H
TechnoLo	Techno Kit L
S. Latin	Small Latin
AfroCuba	AfroCubanKit
AfrCuba2	AfroCubanKt2
BrazilKt	BrazillianKt
PopLatin	Pop Latin Kt
DarkRoom	Dark Room Kt
ElectrKt	Electro Kit
Anal.Kt2	Analog Kit 2
HipHopKt	Hip Hop Kit
PerigeKt	Perigee Kit
BrushKt2	Brush Kit 2
SymphnKt	Symphony Kit
Ntrl Kit	Natural Kit
NtrlFunk	Ntrl Funk Kt
Lv StdKt	LiveStdrdKit
LvFunkKt	LiveFunk Kit
Lv Brush	LiveBrushKit
Std&Perc	LiveStd&Perc
FunkPerc	LvFunkPercKt
Brush&P.	LvBrush&Perc
F-Coquet	Fem-Coquette
Det.EP 8	Detuned EP 8