ID	Name
LayerCP1	LayeredCP1
GrndPnoK	GrndPianoK
MelloGrP	MelloGrPno
PianoStr	PianoStrng
DreamPno	DreamPiano
DblConGr	DblConGrnd
GrandP #	GrndPiano#
BritPnoK	BritPianoK
BriteP #	BritPiano#
EGndPnoK	ElGrndPnoK
Det.CP80	DetuneCP80
LayerCP2	LayeredCP2
HnkyTnkK	HonkyTonkK
EPiano1K	ElPiano 1K
MellowEP	Mellow EP.
ChorusEP	Chorus EP.
HardEPno	Hard ElPno
VX E.Pno	VX ElPiano
60sElPno	60's ElPno
EPiano1#	El.Piano1#
EPiano2K	ElPiano 2K
Chor.EP2	ChorusEP.2
DXLegend	DX Legend
DXAnalog	DX Analog
DX Kt EP	DX Koto EP
VX EPno2	VX EPiano2
EPiano2#	El.Piano2#
HpschrdK	HrpsichrdK
Hpschrd2	Hrpsichrd2
Hpschrd3	Hrpsichrd3
ClvchrdK	ClvichordK
ClaviWah	ClvchrdWah
PulseClv	PulseClavi
Perc Clv	PierceClav
SupClavi	SuperClavi
Clavi. #	Clavichrd#
FM Celst	FM Celesta
S. Orgel	SmallOrgel
VibrafnK	VibrafoneK
HardVibr	HardVibrfn
MarimbaK	Marimba K
SMarimba	SineMrimba
Balafone	Balaphone
Log Drum	Log Drums
ChrchBel	ChurchBell
Dulcmer2	Dulcimer 2
DetDrwOr	DetDrawOrg
60sDrOrg	60sDrawOrg
60sDrOr2	60sDrawOr2
70sDrOrg	70sDrawOrg
DrawOrg2	DrawOrgan2
60sDrOr3	60sDrawOr3
EvenBar	Even Bar
Organ Ba	Organ Bass
70sDrOr2	70sDrawOr2
CheezOrg	CheeseOrgn
DrawOrg3	DrawOrgan3
ClkGspOr	ClikGospOr
DrawOrg#	DrawOrgan#
70sPcOrg	70sPercOrg
DetPrcOr	DetPercOrg
LightOrg	LightOrgan
PercOrg2	PercOrgan2
PercOrg#	PercOrgan#
RotaryOr	RotaryOrgn
SlwRotar	SlowRotary
FstRotar	FastRotary
RockOrg#	RockOrgan#
ChurOrg3	ChurchOrg3
ChurOrg2	ChurchOrg2
NotreDam	Notre Dame
OrgFlute	OrganFlute
TrmOrgFl	TrmOrFlute
PuffOrgn	Puff Organ
AccordIt	AcordionIt
Harmo. 2	Harmonica2
TngoAcd2	TangoAcod2
NylonGt2	Nylon Gt.2
NylonGt3	Nylon Gt.3
VelGtHrm	VelGtHrmnx
NylonGt#	Nylon Gt.#
SteelGt2	Steel Gt.2
12StrGtr	12-Str Gt.
Nyln&Stl	Nyln&Steel
Stl&Body	Steel&Body
SteelGt#	Steel Gt.#
MelloGtr	Mellow Gt.
Jazz Amp	JazzGtrAmp
OctPlate	Oct. Plate
NekRough	Neck.Rough
PdlSteel	PedalSteel
JazzGtr#	Jazz Gtr.#
ChorusGt	Chorus Gt.
MidT.Gtr	MidToneGt.
MidTGtSt	MidTnGtrSt
NasalGtr	Nasal Gtr.
Funk Gtr	Funk Gtr 1
MuteStlG	MuteSteelG
FunkGtr2	Funk Gtr 2
Mu.DstGt	MuteDistGt
MutedGt#	Muted Gt.#
OvdrGtDt	OvdrGtrDet
Gt.Pinch	Gtr. Pinch
Ovrdriv#	Overdrive#
DstRthmG	DistRthmGt
DistGtr2	Dist.Gtr 2
DistGtr3	Dist.Gtr 3
PowerGt2	PowerGtr.2
PowerGtr	Power Gtr.
Dst.5ths	Dist. 5ths
FeedbkGt	FeedbackGt
FeedbkG2	FeedbackG2
RckRthm2	RockRthm 2
RockRthm	RockRhythm
Dist.Gt#	Dist. Gt.#
GtFeedbk	GtFeedback
GtrHrmo2	GtrHarmo 2
FlangrBa	Flanger Ba
RezChase	Reso.Chase
PickBas2	PickedBas2
HardPick	Hard Pick
Pwr.Fret	PwrFretles
TalkinBa	TalkinBass
SmthSynB	SmthSynBas
ViolinSc	ViolinSect
SlVlnSec	SlowVlnSec
ViolaSec	Viola Sect
SlVlaSec	SlowVlaSec
CellSect	Cello Sect
SlCelloS	SlCelloSec
ContrSec	ContrbSect
SlContrS	SlContrSec
SwellStr	Swell Str.
StSlwStr	St.SlowStr
StereoAh	Stereo Aah
StereoOh	Stereo Ooh
BriteTrp	Bright Trp
Dark Trp	Dark Trmpt
Soft Trp	Soft Trmpt
SweetTrp	SweetTrmpt
NormlTrp	Normal Trp
Bril Trp	Brill. Trp
BrtTromb	BrtTrombon
MelloTrb	MelloTromb
BrilTrmb	Brill.Trmb
BrtBsTrb	BrtBasTrmb
SlowTuba	Slow Tuba
Eufonium	Euphonium
FrHrSolo	FrHornSolo
FrHorn 2	Fr. Horn 2
BrtFrHrn	BriteFrHrn
StBrsSec	StBrasSect
Tenor&Tp	Tenor&Trp
SymphBrs	SymphBrass
LgtAltSx	LgtAltoSax
HyprAlto	Hyper Alto
FakeAlto	Fake Alto
TenrSax2	TenorSax 2
SuperTnr	SuperTenor
BasClari	BassClari.
NeatBrth	NeatBreath
Pastoral	Pastorale
HollowSq	Hollow Sqr
LightPad	Light Pad
PolyPd80	PolyPad 80
Prcesion	Precession
CutNoise	Cut Noise
CutNoiz2	CutNoise 2
DstCutNz	DstCutNoiz
Str Slap	StringSlap
B.Slide	Bass Slide
P.Scrape	PickScrape
Fl.KClik	FltKyClick
HorseGlp	HorseGalop
BirdTwit	Bird Tweet
PhonCall	Phone Call
DoorSqek	DoorSqueak
DoorSlam	Door Slam
ScratchC	ScratchCut
Scratch2	ScratchSpl
WindChim	Windchimes
TeleFon2	Telephone2
Scratch3	Scratch 3
Turntabl	Turn Table
Turntabl	Turn Table
CarStart	Car Start
CarTyreS	CarTyreSq.
Car Pass	CarPassing
CarCrash	Car Crash
JetPlane	Jet Plane
Submarin	Submarine
LaughVox	Laugh Vox
ScreamVx	Scream Vox
Heart	Heartbeat
Footstep	Footsteps
Applauz2	Applause 2
Applauz2	Applause 2
MchinGun	MachineGun
LaserGun	Laser Gun
Xplosion	Explosion
Firework	Fireworks
SFX Kt 2	SFX Kit 2
TechnoKt	Techno Kit
TechnoHi	TechnoKtHi
TechnoLo	TechnoKtLo
SakuraKt	Sakura Kit
S. Latin	SmallLatin
ChinaKit	China Kit
AfroCuba	AfroCubaKt
AfrCuba2	AfrCubaKt2
BrazilKt	Brazil Kit
PopLatin	PopLatinKt
BrightKt	Bright Kit
RogueKit	Rogue Kit
DarkRoom	DarkRoomKt
RockKit2	Rock Kit 2
ElectrKt	ElectroKit
Anal.Kt2	AnalogKit2
DanceKit	Dance Kit
HipHopKt	Hip Hop Kt
JungleKt	Jungle Kit
ApogeeKt	Apogee Kit
PerigeKt	PerigeeKit
JazzKit2	Jazz Kit 2
BrushKit	Brush Kit
BrushKt2	BrushKit 2
SymphnKt	SymphonyKt
Ntrl Kit	NaturalKit
NtrlFunk	NtrlFunkKt
TrampKit	Tramp Kit
AmberKit	Amber Kit
CoffinKt	Coffin Kit
Lv StdKt	LiveStdKit
LvFunkKt	LiveFunkKt
Lv Brush	LvBrushKit
Std&Perc	LvStd&Perc
FunkPerc	LvFunkPerc
Brush&P.	LvBrush&P.
RockKit3	Rock Kit 3
F-Coquet	Fem-Coquet
Det.EP 8	Det. EP 8